1111111111111111111
1000000000000000001
100110C000PE1C00011
11111110001C0001111
1111111111111111111