1111111111111111111111111111111111
1E000000000X00XC00000C000000000001
101X01010010000X101001000000010101
101001001010101000100100X000010101
1P0000000C00C000X00000000X000000C1
1111111111111111111111111111111111
