1111111111111111111
1000000000C00000001
10000E0C0C000000001
10000C0C0P0C0000011
1111111111111111111