1111111111111111111
111101E000000000001
11001PC100001C00011
10111110001C0001111
1111111111111111111