1111111111111111111111111111
1000000000CP0000001C00000001
10000C0C000C00000000000C0C01
1000000000C000E00010000C0C01
1111111111111111111111111111