1111111111111111111111111111111111111111111111111111111
1E000000000X00XC00000C000000000001101001001001010001111
101X01010010000X101001000000010100101001001101010000111
101001001010101000100100X000010100001001000101010011111
1P0000000C00C000X00000000X000000C1101001010101010001111
111111111111111111111111111111111110100101010101000X111
111111111111111111111111111111111110100101010101000X111
111111111111111111111111111111111110100101010101000X111
111111111111111111111111111111111110100101010101000X111
111111111111111111111111111111111110100101010101000X111
111111111111111111111111111111111110100101010101000X111
111111111111111111111111111111111110100101010101000X111
111111111111111111111111111111111110100101010101000X111
111111111111111111111111111111111110100101010101000X111
111111111111111111111111111111111110100101010101000X111
1111111111111111111111111111111111111111111111111111111
111111111111111111111111111111111110100101010101000X111
111111111111111111111111111111111110100101010101000X111
111111111111111111111111111111111110100101010101000X111
111111111111111111111111111111111110100101010101000X111
111111111111111111111111111111111110100101010101000X111
111111111111111111111111111111111110100101010101000X111
111111111111111111111111111111111110100101010101000X111
111111111111111111111111111111111110100101010101000X111
111111111111111111111111111111111110100101010101000X111
111111111111111111111111111111111110100101010101000X111
1111111111111111111111111111111111111111111111111111111
111111111111111111111111111111111110100101010101000X111
111111111111111111111111111111111110100101010101000X111
111111111111111111111111111111111110100101010101000X111
111111111111111111111111111111111110100101010101000X111
1XXXXXXXXXXXXXXXXXXXXXXXXXXXXXXXXXXXXXXXXXXXXXXXXXXXX11
1111111111111111111111111111111111111111111111111111111