1111111111111111111
100000C000C00000001
1001100P000E0000001
1111110000100001111
1111111111111111111