1111111111111111111
100000C000C00000E01
1001100000PE0000001
1111110000100001111
1111111111111111111