1111111111111111111111111111
1000000000C00000001C00000001
10000E0C0C000000001C00000001
10000C0C000C0000011C00000001
1000000000C00000000C00000001
10000P0000C00000001C00000001
10000C0C000C00000110000C0C01
1000000000C000000010000C0C01
10000C0C000C00000110000C0C01
1000000000C000000010000C0C01
11111111111111111110000C0C01
1111111111111111111111111111