111111111111111111111111111111111111111111111111111111
1E000000000X00XC0000C000000000001101001001001010001111
101X01010010000X10100000000010100101001001101010000111
10100100101010100010010X000010100001001000101010011111
1P0000000C00C000X0000000X000000C1101001010101010001111
11111111111111111111111111111111110100101010101000X111
1111111111111111111111111111111110100101010101000X1111
111111111111111111111111111111111110100101010101000X11
1111111111111111111111111111111110100101010101000X1111
11111111111111111111111111111111110100101010101000X111
11111111111111111111111111111111110100101010101000X111
11111111111111111111111111111111110100101010101000X111
11111111111111111111111111111111110100101010101000X111
11111111111111111111111111111111110100101010101000X111
11111111111111111111111111111111110100101010101000X111
111111111111111111111111111111111111111111111111111111
1111111111111111111111111111111111100101010101000X1111
11111111111111111111111111111111111010101010101000X111
11111111111111111111111111111111111010001010101000X111
11111111111111111111111111111111111010011010101000X111
11111111111111111111111111111111111010010010101000X111
11111111111111111111111111111111111010010110101000X111
11111111111111111111111111111111111010010100101000X111
11111111111111111111111111111111111010010101101000X111
11111111111111111111111111111111111010010101001000X111
11111111111111111111111111111111111010010101011000X111
111111111111111111111111111111111111111111111111111111
11111111111111111111111111111111111010010101010100X111
11111111111111111111111111111111111010010101010100X111
11111111111111111111111111111111111010010101010100X111
111111111111111111111111111111111110100101010101000111
1XXXXXXXXXXXXXXXXXXXXXXXXXXXXXXXXXXXXXXXXXXXXXXXXXXX11
111111111111111111111111111111111111111111111111111111